000000000000000000000000
000000000000000000000000
000000040000000400000000
000000100000000010000000
000000101111111010000000
000000101002001010000000
000000101003001010000000
000000101111111010000000
000000100000000010000000
000000040000000400000000
000000000000000000000000
000000000000000000000000
