000000000000000000000000
000000000000000000000000
000000040000000400000000
000000000000000000000000
000000001111111000000000
000000001432341000000000
000000001423241000000000
000000001111111000000000
000000000000000000000000
000000040000000400000000
000000000000000000000000
000000000000000000000000