000000000000000000000000
000000000000000000000000
000000444444444440000000
000000400000000040000000
000000401111111040000000
000000401333331040000000
000000401333331040000000
000000401111111040000000
000000400000000040000000
000000444444444440000000
000000000000000000000000
000000000000000000000000